; 1
## #V###*#
#* H
# ## # ##
 H # ###*
# #*#H
# #     ##
* ### #
# #*  # #*
#@###V#* H

; 2
#@#*#*#*#
H
##*#*#*#
V#######
 *## H*
 #*#### #
 H
#*##*####
# ##  H*#
# *#   #

; 3
#H *##@###
#*# #H  *
 V  ## #V#
## ##
*   *
#V H# ####
H   #
  V*#H V
*  ##    *